season,team,player,nation,pos,age,born,90s,Tackles_Tkl,Tackles_TklW,Tackles_Def 3rd,Tackles_Mid 3rd,Tackles_Att 3rd,Challenges_Tkl,Challenges_Att,Challenges_Tkl%,Challenges_Lost,Blocks_Blocks,Blocks_Sh,Blocks_Pass,Int,Tkl+Int,Clr,Err
2425,Arsenal,Ben White,ENG,DF,27-038,1997,7.7,10,6,8,1,1,9,21,42.9,12,6,5,1,11,21,23,0
2425,Arsenal,Bukayo Saka,ENG,"MF,FW",23-071,2001,9.1,16,10,5,5,6,7,15,46.7,8,12,0,12,2,18,6,0
2425,Arsenal,David Raya,ESP,GK,29-061,1995,11.0,0,0,0,0,0,0,0,,0,0,0,0,1,1,7,3
2425,Arsenal,Declan Rice,ENG,MF,25-306,1999,9.2,14,5,3,9,2,6,11,54.5,5,10,7,3,9,23,14,0
2425,Arsenal,Ethan Nwaneri,ENG,"MF,FW",17-239,2007,0.6,1,0,0,1,0,0,0,,0,4,1,3,0,1,1,0
2425,Arsenal,Gabriel Jesus,BRA,"FW,MF",27-226,1997,1.4,3,2,3,0,0,2,4,50.0,2,4,1,3,2,5,0,0
2425,Arsenal,Gabriel Magalhães,BRA,DF,26-332,1997,10.6,7,4,4,3,0,4,7,57.1,3,23,17,6,6,13,39,1
2425,Arsenal,Gabriel Martinelli,BRA,"MF,FW",23-150,2001,7.6,9,7,1,3,5,4,11,36.4,7,4,0,4,1,10,9,0
2425,Arsenal,Jakub Kiwior,POL,DF,24-274,2000,1.1,0,0,0,0,0,0,1,0.0,1,3,1,2,0,0,9,0
2425,Arsenal,Jorginho,ITA,MF,32-331,1991,1.7,2,1,0,1,1,2,4,50.0,2,0,0,0,0,2,0,1
2425,Arsenal,Jurriën Timber,NED,DF,23-151,2001,7.6,15,8,5,7,3,4,11,36.4,7,10,4,6,4,19,18,1
2425,Arsenal,Kai Havertz,GER,FW,25-157,1999,11.0,9,6,2,4,3,3,10,30.0,7,15,3,12,5,14,25,1
2425,Arsenal,Leandro Trossard,BEL,FW,29-347,1994,6.4,11,8,2,6,3,5,14,35.7,9,9,0,9,5,16,6,0
2425,Arsenal,Martin Ødegaard,NOR,MF,25-334,1998,3.8,7,4,1,5,1,1,4,25.0,3,1,0,1,1,8,0,0
2425,Arsenal,Mikel Merino,ESP,"MF,FW",28-146,1996,3.1,11,8,4,3,4,4,9,44.4,5,8,5,3,6,17,4,1
2425,Arsenal,Myles Lewis-Skelly,ENG,DF,18-050,2006,0.2,1,1,1,0,0,0,0,,0,0,0,0,0,1,1,0
2425,Arsenal,Oleksandr Zinchenko,UKR,"DF,MF",27-336,1996,1.2,0,0,0,0,0,0,1,0.0,1,3,0,3,2,2,3,0
2425,Arsenal,Raheem Sterling,ENG,"MF,FW",29-343,1994,1.4,0,0,0,0,0,0,1,0.0,1,1,0,1,0,0,0,0
2425,Arsenal,Reiss Nelson,ENG,FW,24-341,1999,0.0,1,0,0,1,0,0,1,0.0,1,0,0,0,0,1,1,0
2425,Arsenal,Riccardo Calafiori,ITA,DF,22-180,2002,4.3,12,9,7,4,1,10,16,62.5,6,8,3,5,4,16,13,0
2425,Arsenal,Takehiro Tomiyasu,JPN,DF,26-010,1998,0.1,0,0,0,0,0,0,0,,0,0,0,0,0,0,1,0
2425,Arsenal,Thomas Partey,GHA,"MF,DF",31-155,1993,10.8,32,20,13,9,10,17,31,54.8,14,8,5,3,13,45,25,2
2425,Arsenal,William Saliba,FRA,DF,23-236,2001,9.3,27,17,18,9,0,12,13,92.3,1,7,2,5,7,34,29,1
2425,Aston Villa,Amadou Onana,BEL,MF,23-091,2001,7.8,25,15,13,10,2,8,16,50.0,8,9,5,4,16,41,16,2
2425,Aston Villa,Boubacar Kamara,FRA,MF,24-358,1999,0.4,1,1,0,1,0,0,2,0.0,2,0,0,0,1,2,1,0
2425,Aston Villa,Diego Carlos,BRA,DF,31-245,1993,5.2,4,1,3,1,0,0,1,0.0,1,3,2,1,4,8,18,2
2425,Aston Villa,Emi Buendía,ARG,"MF,FW",27-326,1996,0.3,2,2,1,1,0,0,2,0.0,2,2,0,2,0,2,0,0
2425,Aston Villa,Emiliano Martínez,ARG,GK,32-074,1992,11.0,0,0,0,0,0,0,0,,0,0,0,0,0,0,8,2
2425,Aston Villa,Ezri Konsa,ENG,DF,27-023,1997,9.1,13,8,8,3,2,8,10,80.0,2,4,1,3,6,19,32,0
2425,Aston Villa,Ian Maatsen,NED,DF,22-250,2002,1.8,6,4,2,4,0,2,4,50.0,2,1,0,1,0,6,5,1
2425,Aston Villa,Jacob Ramsey,ENG,"FW,MF",23-171,2001,7.0,7,3,3,3,1,3,5,60.0,2,8,2,6,5,12,2,0
2425,Aston Villa,Jaden Philogene Bidace,ENG,"FW,MF",22-281,2002,2.2,6,4,2,4,0,3,4,75.0,1,1,0,1,0,6,2,0
2425,Aston Villa,Jhon Durán,COL,FW,20-338,2003,3.2,5,4,1,0,4,1,3,33.3,2,3,0,3,0,5,7,0
2425,Aston Villa,John McGinn,SCO,"FW,MF",30-028,1994,6.1,9,5,3,6,0,4,7,57.1,3,7,0,7,2,11,3,0
2425,Aston Villa,Kosta Nedeljković,SRB,DF,18-335,2005,1.1,7,5,1,3,3,2,3,66.7,1,1,0,1,0,7,3,0
2425,Aston Villa,Lamare Bogarde,NED,DF,20-315,2004,1.9,8,4,2,5,1,5,9,55.6,4,1,0,1,1,9,4,0
2425,Aston Villa,Leon Bailey,JAM,"FW,MF",27-098,1997,5.6,2,0,0,1,1,0,2,0.0,2,3,0,3,1,3,6,0
2425,Aston Villa,Lucas Digne,FRA,DF,31-118,1993,9.3,24,15,14,7,3,16,25,64.0,9,11,3,8,14,38,29,0
2425,Aston Villa,Matty Cash,POL,DF,27-100,1997,4.7,10,4,7,3,0,4,8,50.0,4,4,1,3,6,16,19,0
2425,Aston Villa,Morgan Rogers,ENG,"MF,FW",22-112,2002,10.0,8,3,2,4,2,3,9,33.3,6,9,2,7,3,11,6,0
2425,Aston Villa,Ollie Watkins,ENG,FW,28-321,1995,9.3,3,2,0,2,1,0,4,0.0,4,5,0,5,2,5,2,0
2425,Aston Villa,Pau Torres,ESP,DF,27-304,1997,11.0,10,8,6,4,0,4,5,80.0,1,8,4,4,4,14,27,2
2425,Aston Villa,Ross Barkley,ENG,MF,30-346,1993,3.1,6,2,3,3,0,5,7,71.4,2,4,2,2,3,9,3,0
2425,Aston Villa,Youri Tielemans,BEL,MF,27-192,1997,10.8,26,18,12,13,1,14,22,63.6,8,9,4,5,12,38,12,0
2425,Bournemouth,Adam Smith,ENG,DF,33-200,1991,6.7,9,6,5,2,2,4,8,50.0,4,4,1,3,7,16,25,0
2425,Bournemouth,Alex Scott,ENG,MF,21-086,2003,2.9,16,7,8,4,4,12,16,75.0,4,9,1,8,6,22,5,0
2425,Bournemouth,Antoine Semenyo,GHA,FW,24-313,2000,10.7,17,11,5,8,4,5,15,33.3,10,16,3,13,3,20,8,0
2425,Bournemouth,Dango Ouattara,BFA,"FW,DF",22-278,2002,4.6,12,12,2,5,5,7,12,58.3,5,7,1,6,3,15,13,0
2425,Bournemouth,Daniel Jebbison,ENG,FW,21-094,2003,0.3,0,0,0,0,0,0,1,0.0,1,0,0,0,0,0,1,0
2425,Bournemouth,David Brooks,WAL,"MF,FW",27-130,1997,0.5,1,1,0,1,0,1,1,100.0,0,1,1,0,0,1,1,0
2425,Bournemouth,Dean Huijsen,ESP,DF,19-215,2005,2.4,2,1,2,0,0,0,0,,0,3,2,1,3,5,10,0
2425,Bournemouth,Enes Ünal,TUR,"FW,MF",27-189,1997,1.7,1,0,0,0,1,0,1,0.0,1,1,0,1,0,1,3,0
2425,Bournemouth,Evanilson,BRA,FW,25-040,1999,7.9,4,2,0,1,3,2,3,66.7,1,6,1,5,0,4,9,0
2425,Bournemouth,Illia Zabarnyi,UKR,DF,22-075,2002,11.0,13,7,6,7,0,5,10,50.0,5,14,5,9,12,25,53,0
2425,Bournemouth,Julian Araujo,MEX,DF,23-094,2001,3.9,7,3,3,4,0,4,10,40.0,6,3,0,3,4,11,13,0
2425,Bournemouth,Justin Kluivert,NED,"MF,FW",25-194,1999,6.9,8,5,3,3,2,2,5,40.0,3,8,0,8,5,13,11,0
2425,Bournemouth,Kepa Arrizabalaga,ESP,GK,30-043,1994,6.0,0,0,0,0,0,0,1,0.0,1,0,0,0,0,0,3,2
2425,Bournemouth,Lewis Cook,ENG,MF,27-286,1997,10.9,31,18,16,14,1,12,26,46.2,14,15,4,11,19,50,17,0
2425,Bournemouth,Luis Sinisterra,COL,"FW,MF",25-151,1999,2.3,5,1,1,2,2,0,4,0.0,4,3,0,3,0,5,5,0
2425,Bournemouth,Marcos Senesi,ARG,DF,27-189,1997,8.6,29,18,19,8,2,11,20,55.0,9,13,5,8,10,39,38,0
2425,Bournemouth,Marcus Tavernier,ENG,"MF,FW",25-238,1999,8.9,19,11,5,10,4,4,10,40.0,6,4,0,4,3,22,5,0
2425,Bournemouth,Mark Travers,IRL,GK,25-181,1999,3.0,0,0,0,0,0,0,0,,0,0,0,0,0,0,4,0
2425,Bournemouth,Milos Kerkez,HUN,DF,21-008,2003,10.3,15,7,4,9,2,5,10,50.0,5,11,4,7,12,27,27,0
2425,Bournemouth,Neto,BRA,GK,35-119,1989,2.0,0,0,0,0,0,0,0,,0,0,0,0,0,0,1,1
2425,Bournemouth,Philip Billing,DEN,MF,28-157,1996,0.3,1,0,1,0,0,0,0,,0,0,0,0,1,2,0,0
2425,Bournemouth,Ryan Christie,SCO,MF,29-267,1995,7.8,11,7,5,5,1,3,13,23.1,10,16,5,11,6,17,18,1
2425,Bournemouth,Tyler Adams,USA,MF,25-275,1999,1.1,5,2,1,4,0,1,1,100.0,0,4,2,2,4,9,1,0
2425,Brentford,Ben Mee,ENG,"DF,FW",35-055,1989,0.1,1,1,0,1,0,1,1,100.0,0,1,1,0,1,2,0,0
2425,Brentford,Bryan Mbeumo,CMR,FW,25-100,1999,10.9,11,8,5,3,3,5,7,71.4,2,5,2,3,3,14,11,0
2425,Brentford,Christian Nørgaard,DEN,MF,30-250,1994,8.6,22,15,10,12,0,11,16,68.8,5,18,4,14,14,36,20,1
2425,Brentford,Ethan Pinnock,JAM,DF,31-170,1993,11.0,24,13,12,9,3,9,12,75.0,3,16,10,6,15,39,66,2
2425,Brentford,Fabio Carvalho,POR,"FW,MF",22-077,2002,3.2,9,6,3,2,4,3,7,42.9,4,5,1,4,2,11,1,0
2425,Brentford,Frank Onyeka,NGA,MF,26-319,1998,0.3,0,0,0,0,0,0,0,,0,0,0,0,0,0,0,0
2425,Brentford,Keane Lewis-Potter,ENG,"FW,DF",23-267,2001,8.5,16,7,4,9,3,8,12,66.7,4,7,3,4,4,20,14,0
2425,Brentford,Kevin Schade,GER,"FW,MF",22-354,2001,5.4,12,10,3,4,5,6,7,85.7,1,2,1,1,0,12,4,0
2425,Brentford,Kristoffer Ajer,NOR,DF,26-212,1998,7.1,6,5,5,1,0,2,8,25.0,6,8,1,7,6,12,19,0
2425,Brentford,Mads Roerslev,DEN,DF,25-144,1999,5.0,5,3,4,1,0,1,8,12.5,7,5,1,4,2,7,14,0
2425,Brentford,Mark Flekken,NED,GK,31-155,1993,11.0,1,1,1,0,0,1,3,33.3,2,0,0,0,0,1,12,0
2425,Brentford,Mathias Jensen,DEN,MF,28-319,1996,3.9,1,1,1,0,0,0,3,0.0,3,5,1,4,3,4,3,1
2425,Brentford,Mikkel Damsgaard,DEN,"MF,FW",24-135,2000,8.8,28,17,13,7,8,10,22,45.5,12,15,1,14,10,38,19,1
2425,Brentford,Nathan Collins,IRL,DF,23-199,2001,11.0,14,9,9,3,2,10,14,71.4,4,32,24,8,12,26,58,0
2425,Brentford,Ryan Trevitt,ENG,MF,21-248,2003,0.0,1,1,1,0,0,0,0,,0,0,0,0,0,1,0,0
2425,Brentford,Sepp van den Berg,NED,DF,22-331,2001,8.1,14,8,10,2,2,5,9,55.6,4,14,7,7,6,20,30,2
2425,Brentford,Vitaly Janelt,GER,MF,26-189,1998,10.0,13,9,5,4,4,6,12,50.0,6,14,2,12,10,23,26,0
2425,Brentford,Yehor Yarmoliuk,UKR,MF,20-259,2004,1.6,3,2,1,2,0,1,4,25.0,3,6,3,3,4,7,4,0
2425,Brentford,Yoane Wissa,COD,FW,28-073,1996,6.3,2,1,0,0,2,0,3,0.0,3,2,0,2,3,5,3,0
2425,Brentford,Yunus Emre Konak,TUR,"MF,FW",18-310,2006,0.2,1,1,0,1,0,0,1,0.0,1,0,0,0,0,1,0,0
2425,Brighton,Adam Webster,ENG,DF,29-316,1995,0.9,0,0,0,0,0,0,2,0.0,2,4,3,1,1,1,3,1
2425,Brighton,Bart Verbruggen,NED,GK,22-089,2002,9.0,0,0,0,0,0,0,2,0.0,2,0,0,0,0,0,9,2
2425,Brighton,Billy Gilmour,SCO,MF,23-157,2001,1.1,3,3,2,1,0,3,4,75.0,1,1,0,1,0,3,1,0
2425,Brighton,Brajan Gruda,GER,MF,20-168,2004,0.7,3,1,0,3,0,3,4,75.0,1,1,0,1,0,3,1,0
2425,Brighton,Carlos Baleba,CMR,MF,20-317,2004,6.9,22,11,4,11,7,13,22,59.1,9,11,3,8,15,37,2,0
2425,Brighton,Danny Welbeck,ENG,FW,33-355,1990,10.3,9,5,3,5,1,2,9,22.2,7,11,1,10,3,12,5,0
2425,Brighton,Evan Ferguson,IRL,FW,20-027,2004,1.2,1,1,0,1,0,0,1,0.0,1,2,1,1,0,1,1,0
2425,Brighton,Ferdi Kadioglu,TUR,"DF,MF",25-039,1999,4.3,10,6,4,5,1,6,15,40.0,9,2,2,0,8,18,17,0
2425,Brighton,Georginio Rutter,FRA,"FW,MF",22-209,2002,6.7,11,3,6,4,1,4,13,30.8,9,7,0,7,4,15,7,1
2425,Brighton,Igor,BRA,DF,26-282,1998,5.3,1,1,0,0,1,1,2,50.0,1,12,6,6,2,3,22,0
2425,Brighton,Jack Hinshelwood,ENG,"MF,DF",19-218,2005,9.3,12,9,4,6,2,5,11,45.5,6,4,2,2,4,16,14,1
2425,Brighton,Jakub Moder,POL,MF,25-222,1999,0.1,0,0,0,0,0,0,2,0.0,2,0,0,0,0,0,2,0
2425,Brighton,James Milner,ENG,MF,38-316,1986,1.9,5,2,1,3,1,3,3,100.0,0,4,2,2,2,7,2,1
2425,Brighton,Jan Paul van Hecke,NED,DF,24-160,2000,8.1,12,7,9,3,0,6,10,60.0,4,9,5,4,7,19,23,0
2425,Brighton,Jason Steele,ENG,GK,34-089,1990,2.0,0,0,0,0,0,0,0,,0,0,0,0,0,0,1,0
2425,Brighton,Jeremy Sarmiento,ECU,MF,22-152,2002,0.1,0,0,0,0,0,0,0,,0,0,0,0,0,0,0,0
2425,Brighton,João Pedro,BRA,"MF,FW",23-050,2001,3.4,5,3,1,3,1,1,3,33.3,2,2,0,2,3,8,3,0
2425,Brighton,Joël Veltman,NED,DF,32-305,1992,9.6,19,12,12,5,2,12,30,40.0,18,11,5,6,10,29,27,0
2425,Brighton,Julio Enciso,PAR,"MF,FW",20-297,2004,1.0,0,0,0,0,0,0,1,0.0,1,1,0,1,0,0,0,0
2425,Brighton,Kaoru Mitoma,JPN,"FW,MF",27-179,1997,10.2,16,9,4,7,5,9,17,52.9,8,18,0,18,6,22,2,0
2425,Brighton,Lewis Dunk,ENG,DF,32-360,1991,7.8,3,1,3,0,0,1,1,100.0,0,9,5,4,7,10,20,0
2425,Brighton,Mats Wieffer,NED,MF,24-365,1999,2.6,10,5,1,7,2,3,8,37.5,5,7,1,6,2,12,6,2
2425,Brighton,Matt O'Riley,DEN,MF,23-360,2000,0.4,1,1,1,0,0,0,0,,0,0,0,0,1,2,0,0
2425,Brighton,Pervis Estupiñán,ECU,DF,26-299,1998,5.8,17,11,10,6,1,5,11,45.5,6,2,1,1,11,28,18,0
2425,Brighton,Simon Adingra,CIV,"FW,MF",22-319,2002,2.3,6,2,3,2,1,3,5,60.0,2,3,0,3,3,9,1,0
2425,Brighton,Tariq Lamptey,GHA,DF,24-046,2000,0.1,0,0,0,0,0,0,1,0.0,1,1,1,0,0,0,0,0
2425,Brighton,Yankuba Minteh,GAM,"FW,MF",20-116,2004,4.5,5,3,1,1,3,3,11,27.3,8,7,0,7,3,8,4,0
2425,Brighton,Yasin Ayari,SWE,MF,21-040,2003,5.5,21,11,3,13,5,8,16,50.0,8,6,1,5,6,27,6,0
2425,Chelsea,Axel Disasi,FRA,DF,26-249,1998,1.0,1,1,1,0,0,1,3,33.3,2,1,0,1,1,2,3,0
2425,Chelsea,Benoît Badiashile,FRA,DF,23-234,2001,0.4,1,1,0,1,0,0,0,,0,0,0,0,1,2,2,0
2425,Chelsea,Christopher Nkunku,FRA,FW,27-001,1997,1.8,3,3,0,1,2,2,2,100.0,0,3,1,2,1,4,3,0
2425,Chelsea,Cole Palmer,ENG,"MF,FW",22-193,2002,10.6,9,6,5,4,0,3,9,33.3,6,5,1,4,3,12,6,0
2425,Chelsea,Enzo Fernández,ARG,MF,23-303,2001,6.8,21,10,6,8,7,10,25,40.0,15,7,1,6,2,23,6,2
2425,Chelsea,Jadon Sancho,ENG,FW,24-235,2000,3.4,1,1,1,0,0,1,3,33.3,2,0,0,0,0,1,0,0
2425,Chelsea,João Félix,POR,"MF,FW",25-005,1999,1.4,2,0,1,0,1,1,2,50.0,1,1,0,1,1,3,2,0
2425,Chelsea,Kiernan Dewsbury-Hall,ENG,MF,26-070,1998,0.5,0,0,0,0,0,0,0,,0,1,0,1,1,1,1,1
2425,Chelsea,Levi Colwill,ENG,DF,21-263,2003,11.0,10,7,8,2,0,2,5,40.0,3,14,10,4,15,25,42,1
2425,Chelsea,Malo Gusto,FRA,DF,21-180,2003,8.1,19,13,12,6,1,10,23,43.5,13,14,4,10,10,29,16,1
2425,Chelsea,Marc Cucurella,ESP,DF,26-116,1998,8.2,14,9,10,4,0,5,14,35.7,9,13,5,8,9,23,26,0
2425,Chelsea,Marc Guiu,ESP,FW,18-316,2006,0.3,0,0,0,0,0,0,0,,0,0,0,0,0,0,0,0
2425,Chelsea,Moisés Caicedo,ECU,MF,23-013,2001,10.8,38,25,18,17,3,22,34,64.7,12,16,5,11,18,56,15,0
2425,Chelsea,Mykhailo Mudryk,UKR,FW,23-315,2001,1.7,2,2,2,0,0,0,0,,0,3,1,2,0,2,1,0
2425,Chelsea,Nicolas Jackson,SEN,FW,23-148,2001,9.6,3,3,0,2,1,0,2,0.0,2,8,1,7,1,4,8,0
2425,Chelsea,Noni Madueke,ENG,FW,22-250,2002,8.4,12,9,5,6,1,7,17,41.2,10,7,0,7,3,15,4,0
2425,Chelsea,Pedro Neto,POR,FW,24-251,2000,6.2,8,3,2,5,1,4,7,57.1,3,7,0,7,4,12,2,0
2425,Chelsea,Reece James,ENG,DF,24-343,1999,2.7,2,2,2,0,0,1,3,33.3,2,4,2,2,3,5,5,1
2425,Chelsea,Renato Veiga,POR,"DF,MF",21-109,2003,1.9,8,5,5,3,0,4,8,50.0,4,3,1,2,1,9,2,0
2425,Chelsea,Robert Sánchez,ESP,GK,26-363,1997,11.0,0,0,0,0,0,0,1,0.0,1,0,0,0,0,0,10,3
2425,Chelsea,Roméo Lavia,BEL,MF,20-314,2004,3.7,11,5,4,6,1,5,11,45.5,6,4,0,4,7,18,5,0
2425,Chelsea,Tosin Adarabioyo,ENG,DF,27-052,1997,1.9,2,2,2,0,0,1,1,100.0,0,2,2,0,1,3,8,0
2425,Chelsea,Wesley Fofana,FRA,DF,23-334,2000,9.6,10,9,4,6,0,4,9,44.4,5,14,9,5,12,22,46,1
2425,Crystal Palace,Adam Wharton,ENG,MF,20-166,2004,6.9,18,10,9,9,0,9,26,34.6,17,5,0,5,10,28,13,0
2425,Crystal Palace,Asher Agbinone,ENG,MF,19-048,2005,0.1,2,1,0,2,0,0,0,,0,0,0,0,0,2,0,0
2425,Crystal Palace,Caleb Kporha,ENG,DF,18-123,2006,0.0,0,0,0,0,0,0,0,,0,0,0,0,0,0,0,0
2425,Crystal Palace,Chadi Riad,MAR,DF,21-151,2003,1.0,5,2,2,2,1,2,3,66.7,1,0,0,0,2,7,0,0
2425,Crystal Palace,Cheick Doucouré,MLI,MF,24-312,2000,1.5,6,3,1,4,1,1,4,25.0,3,2,0,2,3,9,1,0
2425,Crystal Palace,Chris Richards,USA,DF,24-232,2000,3.8,10,5,5,4,1,6,11,54.5,5,7,1,6,3,13,17,0
2425,Crystal Palace,Daichi Kamada,JPN,MF,28-102,1996,6.9,19,9,6,11,2,5,16,31.3,11,9,2,7,7,26,8,0
2425,Crystal Palace,Daniel Muñoz,COL,"DF,MF",28-173,1996,10.0,38,27,20,13,5,15,27,55.6,12,11,1,10,12,50,31,0
2425,Crystal Palace,Dean Henderson,ENG,GK,27-248,1997,11.0,1,0,1,0,0,1,2,50.0,1,0,0,0,0,1,8,0
2425,Crystal Palace,Eberechi Eze,ENG,"MF,FW",26-139,1998,9.0,15,8,6,7,2,6,14,42.9,8,6,0,6,3,18,3,1
2425,Crystal Palace,Eddie Nketiah,ENG,"MF,FW",25-169,1999,5.4,8,3,3,2,3,3,7,42.9,4,5,0,5,1,9,5,0
2425,Crystal Palace,Ismaila Sarr,SEN,"MF,FW",26-264,1998,5.4,2,1,0,1,1,0,6,0.0,6,6,0,6,3,5,4,0
2425,Crystal Palace,Jean-Philippe Mateta,FRA,FW,27-140,1997,8.4,2,1,0,1,1,0,4,0.0,4,5,0,5,0,2,7,0
2425,Crystal Palace,Jefferson Lerma,COL,"MF,DF",30-021,1994,4.6,4,2,1,2,1,3,6,50.0,3,9,4,5,7,11,9,0
2425,Crystal Palace,Jeffrey Schlupp,GHA,"MF,DF",31-328,1992,0.8,2,0,1,0,1,0,1,0.0,1,3,0,3,0,2,2,0
2425,Crystal Palace,Joachim Andersen,DEN,DF,28-168,1996,1.0,1,1,1,0,0,1,2,50.0,1,0,0,0,0,1,7,0
2425,Crystal Palace,Jordan Ayew,GHA,"FW,MF",33-065,1991,0.2,1,0,0,0,1,0,0,,0,0,0,0,0,1,0,0
2425,Crystal Palace,Justin Devenny,NIR,MF,21-035,2003,0.8,3,2,3,0,0,2,2,100.0,0,0,0,0,0,3,1,0
2425,Crystal Palace,Marc Guéhi,ENG,DF,24-125,2000,11.0,13,7,9,4,0,7,11,63.6,4,22,12,10,8,21,66,1
2425,Crystal Palace,Maxence Lacroix,FRA,DF,24-223,2000,8.0,13,8,11,1,1,4,11,36.4,7,12,5,7,14,27,34,1
2425,Crystal Palace,Nathaniel Clyne,ENG,"DF,MF",33-224,1991,3.3,10,6,7,2,1,5,6,83.3,1,2,1,1,3,13,10,1
2425,Crystal Palace,Odsonne Édouard,FRA,"MF,FW",26-304,1998,1.3,1,0,0,1,0,0,2,0.0,2,1,0,1,0,1,1,0
2425,Crystal Palace,Trevoh Chalobah,ENG,DF,25-133,1999,5.0,9,7,3,5,1,5,11,45.5,6,9,4,5,12,21,28,2
2425,Crystal Palace,Tyrick Mitchell,ENG,"DF,MF",25-075,1999,10.4,31,22,19,9,3,6,12,50.0,6,20,3,17,5,36,25,1
2425,Crystal Palace,Will Hughes,ENG,MF,29-212,1995,5.1,17,9,2,9,6,7,17,41.2,10,6,2,4,5,22,3,0
2425,Everton,Abdoulaye Doucouré,MLI,MF,31-319,1993,7.2,12,6,7,5,0,4,4,100.0,0,11,3,8,3,15,5,0
2425,Everton,Ashley Young,ENG,DF,39-129,1985,8.7,22,11,11,9,2,13,21,61.9,8,3,1,2,10,32,24,0
2425,Everton,Beto,GNB,FW,26-289,1998,1.1,1,0,0,0,1,0,1,0.0,1,1,0,1,0,1,2,0
2425,Everton,Dominic Calvert-Lewin,ENG,FW,27-244,1997,10.0,6,4,1,2,3,0,1,0.0,1,3,1,2,5,11,11,0
2425,Everton,Dwight McNeil,ENG,"MF,FW",24-359,1999,9.9,8,4,5,3,0,5,12,41.7,7,5,0,5,5,13,1,0
2425,Everton,Harrison Armstrong,ENG,MF,17-301,2007,0.0,0,0,0,0,0,0,1,0.0,1,0,0,0,0,0,0,0
2425,Everton,Idrissa Gana Gueye,SEN,MF,35-050,1989,8.2,30,18,17,8,5,12,20,60.0,8,12,2,10,11,41,8,0
2425,Everton,Iliman Ndiaye,SEN,FW,24-254,2000,9.0,20,11,8,5,7,11,18,61.1,7,11,3,8,13,33,8,0
2425,Everton,Jack Harrison,ENG,FW,27-361,1996,7.0,10,5,5,2,3,5,13,38.5,8,4,0,4,4,14,12,2
2425,Everton,Jake O'Brien,IRL,DF,23-184,2001,0.3,2,2,1,1,0,2,2,100.0,0,1,0,1,0,2,0,0
2425,Everton,James Garner,ENG,"DF,MF",23-247,2001,2.8,10,8,6,4,0,7,10,70.0,3,2,2,0,4,14,9,0
2425,Everton,James Tarkowski,ENG,DF,31-362,1992,11.0,27,16,14,11,2,13,22,59.1,9,17,13,4,11,38,64,1
2425,Everton,Jarrad Branthwaite,ENG,DF,22-141,2002,2.1,5,2,4,1,0,3,3,100.0,0,3,1,2,4,9,10,0
2425,Everton,Jesper Lindstrøm,DEN,FW,24-260,2000,3.9,12,5,4,8,0,4,11,36.4,7,8,2,6,3,15,1,0
2425,Everton,Jordan Pickford,ENG,GK,30-253,1994,11.0,0,0,0,0,0,0,0,,0,0,0,0,1,1,12,1
2425,Everton,Mason Holgate,ENG,"FW,DF",28-024,1996,0.1,0,0,0,0,0,0,0,,0,0,0,0,0,0,0,0
2425,Everton,Michael Keane,ENG,DF,31-309,1993,9.0,10,7,7,2,1,7,10,70.0,3,9,6,3,10,20,50,0
2425,Everton,Orel Mangala,BEL,MF,26-242,1998,5.1,11,5,1,10,0,4,6,66.7,2,0,0,0,11,22,3,0
2425,Everton,Roman Dixon,ENG,DF,19-325,2004,1.0,5,5,3,2,0,4,4,100.0,0,1,0,1,1,6,3,0
2425,Everton,Séamus Coleman,IRL,DF,36-035,1988,1.0,1,0,0,1,0,1,2,50.0,1,2,1,1,0,1,2,0
2425,Everton,Tim Iroegbunam,ENG,MF,21-138,2003,4.3,18,9,9,4,5,7,12,58.3,5,6,0,6,8,26,5,1
2425,Everton,Vitaliy Mykolenko,UKR,DF,25-170,1999,8.3,12,8,9,3,0,6,11,54.5,5,5,2,3,7,19,32,1
2425,Fulham,Adama Traoré,ESP,"FW,MF",28-295,1996,8.0,7,5,4,2,1,2,5,40.0,3,4,0,4,1,8,4,1
2425,Fulham,Alex Iwobi,NGA,FW,28-196,1996,10.5,18,11,7,8,3,6,9,66.7,3,6,0,6,4,22,13,0
2425,Fulham,Andreas Pereira,BRA,MF,28-319,1996,9.3,7,2,2,3,2,2,14,14.3,12,5,1,4,3,10,2,0
2425,Fulham,Antonee Robinson,USA,DF,27-099,1997,11.0,33,22,18,14,1,17,30,56.7,13,9,1,8,20,53,39,0
2425,Fulham,Bernd Leno,GER,GK,32-256,1992,11.0,0,0,0,0,0,0,0,,0,1,0,1,0,0,1,3
2425,Fulham,Calvin Bassey,NGA,DF,24-320,1999,11.0,12,8,8,4,0,3,5,60.0,2,17,10,7,4,16,36,2
2425,Fulham,Emile Smith Rowe,ENG,MF,24-110,2000,8.8,17,11,5,5,7,4,10,40.0,6,7,0,7,7,24,5,0
2425,Fulham,Harrison Reed,ENG,MF,29-293,1995,0.7,5,2,2,2,1,0,2,0.0,2,1,0,1,1,6,2,0
2425,Fulham,Harry Wilson,WAL,"FW,MF",27-238,1997,0.9,1,1,1,0,0,0,1,0.0,1,1,0,1,0,1,1,0
2425,Fulham,Issa Diop,FRA,DF,27-311,1997,4.4,8,5,5,3,0,3,5,60.0,2,4,3,1,1,9,19,0
2425,Fulham,Jay Stansfield,ENG,MF,21-357,2002,0.0,0,0,0,0,0,0,0,,0,0,0,0,0,0,0,0
2425,Fulham,Joachim Andersen,DEN,DF,28-168,1996,6.7,6,3,6,0,0,4,7,57.1,3,7,5,2,11,17,42,0
2425,Fulham,Jorge Cuenca,ESP,DF,24-364,1999,0.0,1,1,1,0,0,1,1,100.0,0,0,0,0,0,1,1,0
2425,Fulham,Kenny Tete,NED,DF,29-037,1995,10.6,30,18,12,10,8,11,20,55.0,9,16,6,10,21,51,28,0
2425,Fulham,Raúl Jiménez,MEX,FW,33-194,1991,7.4,10,5,1,6,3,2,7,28.6,5,5,1,4,4,14,5,2
2425,Fulham,Reiss Nelson,ENG,FW,24-341,1999,3.2,4,2,2,1,1,2,8,25.0,6,9,0,9,0,4,0,0
2425,Fulham,Rodrigo Muniz,BRA,FW,23-195,2001,3.6,0,0,0,0,0,0,0,,0,1,1,0,1,1,4,0
2425,Fulham,Sander Berge,NOR,MF,26-275,1998,5.8,14,8,6,6,2,5,8,62.5,3,10,4,6,12,26,5,0
2425,Fulham,Saša Lukić,SRB,MF,28-094,1996,6.1,12,6,6,5,1,3,15,20.0,12,6,3,3,8,20,6,0
2425,Fulham,Timothy Castagne,BEL,DF,28-346,1995,0.4,4,2,2,2,0,3,4,75.0,1,0,0,0,0,4,2,0
2425,Fulham,Tom Cairney,SCO,MF,33-300,1991,1.4,4,1,1,1,2,1,2,50.0,1,1,0,1,2,6,0,0
2425,Ipswich Town,Ali Al Hamadi,IRQ,FW,22-259,2002,0.4,1,0,0,0,1,0,1,0.0,1,0,0,0,0,1,2,0
2425,Ipswich Town,Arijanet Muric,KVX,GK,26-008,1998,10.0,0,0,0,0,0,0,2,0.0,2,0,0,0,0,0,5,3
2425,Ipswich Town,Axel Tuanzebe,COD,DF,27-001,1997,6.7,15,9,11,1,3,8,12,66.7,4,7,3,4,10,25,21,0
2425,Ipswich Town,Ben Johnson,ENG,"DF,FW",24-296,2000,4.5,18,9,13,5,0,12,18,66.7,6,6,2,4,8,26,8,0
2425,Ipswich Town,Cameron Burgess,AUS,DF,29-025,1995,4.0,2,2,2,0,0,0,0,,0,4,3,1,5,7,31,1
2425,Ipswich Town,Chiedozie Ogbene,IRL,FW,27-198,1997,2.6,7,3,1,2,4,2,4,50.0,2,1,0,1,1,8,3,0
2425,Ipswich Town,Christian Walton,ENG,GK,29-006,1995,1.0,0,0,0,0,0,0,1,0.0,1,0,0,0,0,0,0,0
2425,Ipswich Town,Conor Chaplin,ENG,"MF,FW",27-273,1997,3.1,5,3,3,2,0,3,6,50.0,3,4,0,4,2,7,1,0
2425,Ipswich Town,Conor Townsend,ENG,MF,31-256,1993,0.0,1,1,1,0,0,0,0,,0,0,0,0,0,1,0,0
2425,Ipswich Town,Dara O'Shea,IRL,DF,25-256,1999,7.7,8,5,5,3,0,3,5,60.0,2,17,15,2,13,21,45,1
2425,Ipswich Town,George Edmundson,ENG,DF,27-076,1997,0.0,0,0,0,0,0,0,0,,0,0,0,0,0,0,0,0
2425,Ipswich Town,George Hirst,ENG,FW,25-274,1999,2.0,1,1,1,0,0,0,1,0.0,1,0,0,0,0,1,4,0
2425,Ipswich Town,Harry Clarke,ENG,DF,23-258,2001,1.1,2,2,2,0,0,2,3,66.7,1,1,1,0,1,3,4,0
2425,Ipswich Town,Jack Clarke,ENG,FW,23-358,2000,4.0,10,6,3,6,1,4,11,36.4,7,3,0,3,2,12,6,0
2425,Ipswich Town,Jack Taylor,IRL,MF,26-145,1998,1.5,1,0,0,1,0,1,5,20.0,4,1,0,1,2,3,7,0
2425,Ipswich Town,Jacob Greaves,ENG,DF,24-064,2000,7.0,14,6,6,8,0,7,11,63.6,4,8,6,2,8,22,41,1
2425,Ipswich Town,Jens Cajuste,SWE,MF,25-097,1999,3.0,6,3,1,4,1,2,6,33.3,4,8,1,7,2,8,4,0
2425,Ipswich Town,Kalvin Phillips,ENG,MF,28-349,1995,6.0,14,6,4,9,1,8,18,44.4,10,16,3,13,7,21,11,1
2425,Ipswich Town,Leif Davis,ENG,DF,24-308,2000,11.0,21,12,18,2,1,16,26,61.5,10,10,1,9,11,32,31,0
2425,Ipswich Town,Liam Delap,ENG,FW,21-281,2003,8.6,3,1,1,1,1,0,6,0.0,6,4,0,4,1,4,10,0
2425,Ipswich Town,Luke Woolfenden,ENG,DF,26-025,1998,4.2,1,1,1,0,0,0,2,0.0,2,8,3,5,8,9,22,0
2425,Ipswich Town,Marcus Harness,ENG,MF,28-265,1996,0.5,1,0,0,0,1,0,3,0.0,3,2,1,1,0,1,1,0
2425,Ipswich Town,Massimo Luongo,AUS,MF,32-051,1992,1.6,5,3,5,0,0,4,6,66.7,2,3,2,1,2,7,2,0
2425,Ipswich Town,Omari Hutchinson,ENG,"MF,FW",21-016,2003,9.7,8,4,3,3,2,5,20,25.0,15,11,1,10,5,13,4,0
2425,Ipswich Town,Sam Morsy,EGY,MF,33-066,1991,9.9,29,17,15,11,3,13,23,56.5,10,12,4,8,6,35,16,1
2425,Ipswich Town,Sammie Szmodics,IRL,"FW,MF",29-052,1995,6.0,6,4,2,3,1,2,5,40.0,3,7,1,6,4,10,6,0
2425,Ipswich Town,Wes Burns,WAL,FW,29-358,1994,4.5,5,5,0,4,1,2,5,40.0,3,3,0,3,3,8,4,2
2425,Leicester City,Abdul Fatawu Issahaku,GHA,FW,20-252,2004,6.4,21,15,13,2,6,11,19,57.9,8,7,0,7,4,25,12,0
2425,Leicester City,Bilal El Khannouss,MAR,"MF,FW",20-189,2004,2.2,3,2,1,1,1,0,1,0.0,1,0,0,0,0,3,1,0
2425,Leicester City,Bobby Reid,JAM,FW,31-287,1993,1.8,1,1,0,1,0,0,3,0.0,3,4,1,3,0,1,3,0
2425,Leicester City,Boubakary Soumaré,FRA,MF,25-262,1999,1.6,3,2,3,0,0,1,2,50.0,1,2,1,1,2,5,0,0
2425,Leicester City,Caleb Okoli,ITA,DF,23-125,2001,7.0,17,9,6,10,1,8,10,80.0,2,15,10,5,7,24,48,1
2425,Leicester City,Conor Coady,ENG,DF,31-264,1993,0.1,0,0,0,0,0,0,0,,0,2,1,1,1,1,2,0
2425,Leicester City,Facundo Buonanotte,ARG,"MF,FW",19-328,2004,8.1,22,9,7,8,7,10,29,34.5,19,19,4,15,5,27,7,0
2425,Leicester City,Hamza Choudhury,ENG,MF,27-045,1997,0.2,0,0,0,0,0,0,0,,0,0,0,0,1,1,1,0
2425,Leicester City,Harry Winks,ENG,MF,28-287,1996,9.5,12,7,6,4,2,5,13,38.5,8,10,4,6,3,15,14,0
2425,Leicester City,James Justin,ENG,DF,26-266,1998,9.9,24,14,14,7,3,12,23,52.2,11,10,2,8,14,38,46,0
2425,Leicester City,Jamie Vardy,ENG,FW,37-309,1987,9.4,3,3,2,1,0,0,2,0.0,2,1,0,1,1,4,11,0
2425,Leicester City,Jannik Vestergaard,DEN,DF,32-104,1992,4.0,6,1,3,3,0,0,1,0.0,1,3,1,2,3,9,25,1
2425,Leicester City,Jordan Ayew,GHA,"FW,MF",33-065,1991,5.5,11,5,3,6,2,2,5,40.0,3,5,0,5,4,15,2,0
2425,Leicester City,Kasey McAteer,IRL,"FW,DF",22-359,2001,0.4,4,2,4,0,0,2,3,66.7,1,4,0,4,0,4,3,0
2425,Leicester City,Mads Hermansen,DEN,GK,24-127,2000,11.0,1,1,1,0,0,1,1,100.0,0,1,0,1,0,1,7,1
2425,Leicester City,Odsonne Édouard,FRA,FW,26-304,1998,0.3,1,1,1,0,0,0,0,,0,0,0,0,0,1,1,0
2425,Leicester City,Oliver Skipp,ENG,MF,24-060,2000,4.5,4,2,1,2,1,3,4,75.0,1,7,3,4,4,8,6,0
2425,Leicester City,Ricardo Pereira,POR,DF,31-040,1993,1.6,3,2,0,1,2,1,4,25.0,3,3,1,2,1,4,0,0
2425,Leicester City,Stephy Mavididi,ENG,FW,26-168,1998,6.8,13,9,5,5,3,6,16,37.5,10,12,1,11,1,14,4,0
2425,Leicester City,Victor Bernth Kristiansen,DEN,DF,21-335,2002,9.5,31,24,22,8,1,15,26,57.7,11,17,7,10,12,43,28,0
2425,Leicester City,Wilfred Ndidi,NGA,MF,27-335,1996,10.2,36,20,21,12,3,10,21,47.6,11,25,10,15,6,42,31,0
2425,Leicester City,Wout Faes,BEL,DF,26-226,1998,11.0,17,12,14,2,1,7,19,36.8,12,25,18,7,6,23,65,2
2425,Liverpool,Alexis Mac Allister,ARG,MF,25-327,1998,8.6,26,19,8,16,2,16,31,51.6,15,20,0,20,4,30,8,0
2425,Liverpool,Alisson,BRA,GK,32-044,1992,5.9,0,0,0,0,0,0,0,,0,0,0,0,0,0,2,0
2425,Liverpool,Andrew Robertson,SCO,DF,30-249,1994,8.4,10,7,7,2,1,8,14,57.1,6,2,1,1,5,15,11,0
2425,Liverpool,Caoimhín Kelleher,IRL,GK,25-358,1998,5.0,0,0,0,0,0,0,0,,0,0,0,0,0,0,0,1
2425,Liverpool,Cody Gakpo,NED,FW,25-192,1999,4.7,9,5,4,3,2,6,8,75.0,2,6,0,6,4,13,5,0
2425,Liverpool,Conor Bradley,NIR,DF,21-129,2003,1.6,1,1,1,0,0,1,5,20.0,4,0,0,0,2,3,10,0
2425,Liverpool,Curtis Jones,ENG,MF,23-290,2001,4.6,10,5,2,7,1,5,7,71.4,2,8,4,4,1,11,5,0
2425,Liverpool,Darwin Núñez,URU,FW,25-144,1999,4.7,10,8,6,2,2,2,8,25.0,6,1,0,1,1,11,5,0
2425,Liverpool,Diogo Jota,POR,FW,27-347,1996,5.5,3,1,0,2,1,2,6,33.3,4,1,0,1,3,6,3,0
2425,Liverpool,Dominik Szoboszlai,HUN,MF,24-021,2000,8.3,5,0,1,3,1,2,8,25.0,6,16,2,14,4,9,5,0
2425,Liverpool,Federico Chiesa,ITA,FW,27-021,1997,0.2,0,0,0,0,0,0,0,,0,0,0,0,0,0,0,0
2425,Liverpool,Harvey Elliott,ENG,FW,21-225,2003,0.1,0,0,0,0,0,0,0,,0,0,0,0,0,0,0,0
2425,Liverpool,Ibrahima Konaté,FRA,DF,25-174,1999,9.8,13,9,9,3,1,8,10,80.0,2,13,5,8,4,17,44,1
2425,Liverpool,Jarell Quansah,ENG,DF,21-291,2003,0.5,2,2,1,1,0,0,0,,0,1,1,0,1,3,3,0
2425,Liverpool,Joe Gomez,ENG,DF,27-176,1997,0.6,5,4,2,3,0,5,6,83.3,1,3,2,1,1,6,3,0
2425,Liverpool,Kostas Tsimikas,GRE,DF,28-187,1996,2.6,12,7,8,2,2,6,8,75.0,2,3,1,2,3,15,6,0
2425,Liverpool,Luis Díaz,COL,FW,27-307,1997,7.2,12,7,5,6,1,5,12,41.7,7,7,0,7,3,15,4,1
2425,Liverpool,Mohamed Salah,EGY,FW,32-153,1992,10.7,7,5,2,3,2,2,3,66.7,1,1,0,1,2,9,4,0
2425,Liverpool,Ryan Gravenberch,NED,MF,22-183,2002,11.0,20,14,8,7,5,10,18,55.6,8,16,3,13,21,41,14,0
2425,Liverpool,Trent Alexander-Arnold,ENG,DF,26-039,1998,9.6,31,24,19,8,4,20,32,62.5,12,8,3,5,8,39,12,0
2425,Liverpool,Virgil van Dijk,NED,DF,33-130,1991,11.0,7,3,5,1,1,2,4,50.0,2,6,1,5,20,27,53,1
2425,Liverpool,Vitezslav Jaros,CZE,GK,23-115,2001,0.1,0,0,0,0,0,0,0,,0,0,0,0,0,0,0,0
2425,Liverpool,Wataru Endo,JPN,MF,31-280,1993,0.2,3,2,0,3,0,2,2,100.0,0,2,0,2,0,3,1,0
2425,Manchester City,Bernardo Silva,POR,"MF,FW",30-097,1994,9.3,8,6,0,3,5,3,12,25.0,9,7,1,6,5,13,4,1
2425,Manchester City,Ederson,BRA,GK,31-090,1993,11.0,0,0,0,0,0,0,0,,0,0,0,0,1,1,3,1
2425,Manchester City,Erling Haaland,NOR,FW,24-117,2000,11.0,2,2,0,1,1,1,1,100.0,0,3,0,3,1,3,8,0
2425,Manchester City,Jack Grealish,ENG,"FW,MF",29-066,1995,3.8,5,2,3,0,2,1,3,33.3,2,5,1,4,0,5,3,0
2425,Manchester City,Jahmai Simpson-Pusey,ENG,DF,19-011,2005,1.0,1,0,1,0,0,0,0,,0,1,1,0,0,1,2,0
2425,Manchester City,James Mcatee,ENG,FW,22-028,2002,0.0,0,0,0,0,0,0,0,,0,1,0,1,0,0,0,0
2425,Manchester City,Jeremy Doku,BEL,"FW,MF",22-172,2002,4.5,9,4,2,3,4,1,3,33.3,2,4,0,4,0,9,1,0
2425,Manchester City,John Stones,ENG,"DF,MF",30-171,1994,2.7,3,2,1,2,0,2,2,100.0,0,2,0,2,1,4,7,1
2425,Manchester City,Joško Gvardiol,CRO,DF,22-297,2002,10.5,20,14,11,5,4,10,13,76.9,3,12,5,7,15,35,27,0
2425,Manchester City,Kevin De Bruyne,BEL,MF,33-140,1991,4.1,2,1,2,0,0,0,3,0.0,3,2,0,2,2,4,0,0
2425,Manchester City,Kyle Walker,ENG,DF,34-171,1990,5.2,9,4,3,4,2,7,13,53.8,6,5,2,3,3,12,4,0
2425,Manchester City,Manuel Akanji,SUI,DF,29-119,1995,8.7,7,5,3,2,2,4,7,57.1,3,5,3,2,4,11,24,0
2425,Manchester City,Mateo Kovačić,CRO,MF,30-193,1994,9.8,22,14,5,12,5,11,25,44.0,14,11,0,11,5,27,6,0
2425,Manchester City,Matheus Nunes,POR,"MF,FW",26-080,1998,3.3,9,4,6,2,1,3,6,50.0,3,3,1,2,1,10,3,0
2425,Manchester City,Nathan Aké,NED,DF,29-271,1995,0.8,1,1,1,0,0,1,1,100.0,0,0,0,0,1,2,1,1
2425,Manchester City,Phil Foden,ENG,MF,24-171,2000,5.1,1,0,1,0,0,1,4,25.0,3,4,1,3,3,4,2,0
2425,Manchester City,Rico Lewis,ENG,"DF,MF",19-360,2004,8.6,17,8,7,8,2,5,6,83.3,1,10,2,8,7,24,20,1
2425,Manchester City,Rodri,ESP,MF,28-146,1996,0.7,2,1,1,1,0,0,0,,0,1,0,1,1,3,0,0
2425,Manchester City,Rúben Dias,POR,DF,27-185,1997,8.1,7,4,3,3,1,3,4,75.0,1,4,3,1,10,17,21,1
2425,Manchester City,Sávio,BRA,"FW,MF",20-219,2004,5.8,13,9,3,5,5,3,6,50.0,3,4,0,4,1,14,1,1
2425,Manchester City,İlkay Gündoğan,GER,MF,34-022,1990,7.0,6,3,1,4,1,3,9,33.3,6,1,0,1,3,9,8,0
2425,Manchester Utd,Alejandro Garnacho,ARG,FW,20-137,2004,7.9,12,10,4,3,5,3,11,27.3,8,4,0,4,5,17,6,1
2425,Manchester Utd,Amad Diallo,CIV,FW,22-127,2002,5.4,16,12,4,8,4,8,11,72.7,3,2,0,2,4,20,2,0
2425,Manchester Utd,André Onana,CMR,GK,28-227,1996,11.0,1,1,1,0,0,1,1,100.0,0,0,0,0,0,1,4,1
2425,Manchester Utd,Antony,BRA,FW,24-265,2000,0.3,2,0,2,0,0,1,3,33.3,2,1,0,1,1,3,0,0
2425,Manchester Utd,Bruno Fernandes,POR,"MF,FW",30-068,1994,10.3,28,19,7,15,6,10,24,41.7,14,10,1,9,8,36,13,0
2425,Manchester Utd,Casemiro,BRA,MF,32-266,1992,6.9,31,20,16,9,6,13,29,44.8,16,17,3,14,5,36,25,3
2425,Manchester Utd,Christian Eriksen,DEN,MF,32-275,1992,4.9,7,2,0,5,2,4,9,44.4,5,4,1,3,2,9,4,0
2425,Manchester Utd,Diogo Dalot,POR,DF,25-242,1999,10.6,24,18,13,9,2,11,20,55.0,9,10,5,5,18,42,25,0
2425,Manchester Utd,Harry Maguire,ENG,DF,31-255,1993,2.7,2,1,2,0,0,2,2,100.0,0,2,2,0,6,8,10,0
2425,Manchester Utd,Jonny Evans,NIR,DF,36-317,1988,2.6,7,5,4,3,0,2,3,66.7,1,2,1,1,1,8,10,0
2425,Manchester Utd,Joshua Zirkzee,NED,FW,23-177,2001,4.8,2,0,2,0,0,2,2,100.0,0,6,2,4,2,4,1,0
2425,Manchester Utd,Kobbie Mainoo,ENG,MF,19-210,2005,6.3,16,13,12,3,1,10,15,66.7,5,5,1,4,14,30,2,1
2425,Manchester Utd,Lisandro Martínez,ARG,DF,26-302,1998,9.8,22,13,15,5,2,11,19,57.9,8,11,3,8,22,44,27,1
2425,Manchester Utd,Manuel Ugarte Ribeiro,URU,MF,23-218,2001,3.1,17,11,5,10,2,6,12,50.0,6,0,0,0,4,21,4,1
2425,Manchester Utd,Marcus Rashford,ENG,FW,27-015,1997,8.4,5,3,1,1,3,3,8,37.5,5,8,0,8,3,8,5,0
2425,Manchester Utd,Mason Mount,ENG,"MF,FW",25-310,1999,1.6,5,1,2,3,0,4,5,80.0,1,3,0,3,0,5,0,0
2425,Manchester Utd,Matthijs de Ligt,NED,DF,25-095,1999,8.5,11,5,8,3,0,8,12,66.7,4,10,7,3,13,24,28,0
2425,Manchester Utd,Noussair Mazraoui,MAR,DF,27-001,1997,9.1,39,20,20,13,6,20,31,64.5,11,12,2,10,10,49,31,0
2425,Manchester Utd,Rasmus Højlund,DEN,FW,21-285,2003,4.6,1,0,0,0,1,0,1,0.0,1,2,0,2,0,1,2,0
2425,Manchester Utd,Scott McTominay,SCO,MF,27-343,1996,0.2,0,0,0,0,0,0,1,0.0,1,0,0,0,0,0,1,0
2425,Manchester Utd,Toby Collyer,ENG,MF,20-317,2004,0.5,4,3,1,3,0,2,2,100.0,0,0,0,0,0,4,1,0
2425,Manchester Utd,Victor Lindelöf,SWE,"DF,MF",30-121,1994,0.7,3,0,3,0,0,1,1,100.0,0,1,0,1,2,5,3,0
2425,Newcastle Utd,Alexander Isak,SWE,FW,25-055,1999,8.5,4,2,0,2,2,3,5,60.0,2,9,1,8,1,5,5,0
2425,Newcastle Utd,Anthony Gordon,ENG,FW,23-265,2001,9.4,12,7,7,4,1,6,11,54.5,5,10,0,10,4,16,1,1
2425,Newcastle Utd,Bruno Guimarães,BRA,MF,26-365,1997,10.9,27,15,14,9,4,12,21,57.1,9,12,4,8,12,39,11,2
2425,Newcastle Utd,Dan Burn,ENG,DF,32-190,1992,11.0,9,4,7,2,0,6,12,50.0,6,8,6,2,8,17,49,1
2425,Newcastle Utd,Emil Krafth,SWE,DF,30-105,1994,2.7,2,1,0,1,1,1,2,50.0,1,5,4,1,2,4,10,0
2425,Newcastle Utd,Fabian Schär,SUI,DF,32-331,1991,8.3,9,5,2,7,0,2,7,28.6,5,7,4,3,10,19,31,0
2425,Newcastle Utd,Harvey Barnes,ENG,FW,26-342,1997,5.5,6,4,3,2,1,2,2,100.0,0,2,0,2,4,10,5,0
2425,Newcastle Utd,Jacob Murphy,ENG,FW,29-265,1995,5.5,8,6,4,3,1,5,9,55.6,4,7,0,7,2,10,2,0
2425,Newcastle Utd,Joe Willock,ENG,"MF,FW",25-087,1999,3.7,8,5,3,4,1,5,8,62.5,3,9,1,8,2,10,2,0
2425,Newcastle Utd,Joelinton,BRA,"MF,FW",28-093,1996,10.3,28,18,11,11,6,13,23,56.5,10,14,3,11,8,36,17,1
2425,Newcastle Utd,Kieran Trippier,ENG,DF,34-057,1990,3.1,9,4,4,4,1,5,13,38.5,8,2,1,1,2,11,6,0
2425,Newcastle Utd,Lewis Hall,ENG,DF,20-068,2004,8.7,17,12,6,7,4,11,25,44.0,14,18,11,7,12,29,30,1
2425,Newcastle Utd,Lloyd Kelly,ENG,DF,26-040,1998,2.3,2,2,2,0,0,0,0,,0,4,2,2,1,3,14,0
2425,Newcastle Utd,Miguel Almirón,PAR,FW,30-279,1994,1.2,1,1,1,0,0,1,1,100.0,0,0,0,0,0,1,0,0
2425,Newcastle Utd,Nick Pope,ENG,GK,32-210,1992,11.0,0,0,0,0,0,0,0,,0,1,0,1,1,1,11,3
2425,Newcastle Utd,Sandro Tonali,ITA,MF,24-191,2000,4.6,11,7,2,9,0,4,8,50.0,4,6,3,3,10,21,5,1
2425,Newcastle Utd,Sean Longstaff,ENG,MF,27-016,1997,5.7,24,16,9,8,7,15,21,71.4,6,11,1,10,5,29,3,0
2425,Newcastle Utd,Valentino Livramento,ENG,DF,22-003,2002,7.9,15,9,11,4,0,9,14,64.3,5,13,4,9,10,25,25,1
2425,Newcastle Utd,William Osula,DEN,"FW,MF",21-103,2003,0.1,0,0,0,0,0,0,0,,0,0,0,0,0,0,0,0
2425,Nott'ham Forest,Anthony Elanga,SWE,FW,22-202,2002,7.2,7,4,3,3,1,2,5,40.0,3,4,0,4,3,10,9,0
2425,Nott'ham Forest,Callum Hudson-Odoi,ENG,FW,24-008,2000,8.7,9,6,1,5,3,5,7,71.4,2,4,0,4,5,14,4,1
2425,Nott'ham Forest,Chris Wood,NZL,FW,32-344,1991,9.9,1,1,0,0,1,1,4,25.0,3,2,2,0,2,3,6,0
2425,Nott'ham Forest,Danilo,BRA,MF,23-200,2001,0.2,0,0,0,0,0,0,0,,0,0,0,0,0,0,0,0
2425,Nott'ham Forest,Elliot Anderson,ENG,"MF,FW",22-009,2002,7.0,19,15,9,5,5,10,18,55.6,8,18,4,14,4,23,13,1
2425,Nott'ham Forest,Eric da Silva Moreira,GER,DF,18-196,2006,0.0,0,0,0,0,0,0,0,,0,0,0,0,0,0,0,0
2425,Nott'ham Forest,Harry Toffolo,ENG,DF,29-088,1995,0.4,2,0,1,0,1,0,0,,0,0,0,0,0,2,3,0
2425,Nott'ham Forest,Ibrahim Sangaré,CIV,MF,26-349,1997,2.4,15,9,5,10,0,4,8,50.0,4,4,0,4,2,17,2,0
2425,Nott'ham Forest,James Ward-Prowse,ENG,MF,30-014,1994,3.2,3,1,1,2,0,1,1,100.0,0,3,2,1,5,8,3,0
2425,Nott'ham Forest,Jota Silva,POR,"FW,MF",25-106,1999,2.4,8,2,4,4,0,1,6,16.7,5,3,0,3,7,15,4,0
2425,Nott'ham Forest,Matz Sels,BEL,GK,32-263,1992,11.0,1,1,1,0,0,1,1,100.0,0,0,0,0,0,1,6,0
2425,Nott'ham Forest,Morato,BRA,DF,23-138,2001,0.8,1,1,1,0,0,0,0,,0,1,1,0,2,3,14,0
2425,Nott'ham Forest,Morgan Gibbs-White,ENG,MF,24-293,2000,7.0,13,4,4,7,2,3,5,60.0,2,2,1,1,4,17,5,0
2425,Nott'ham Forest,Murillo,BRA,DF,22-134,2002,11.0,13,8,9,3,1,9,19,47.4,10,17,13,4,6,19,67,1
2425,Nott'ham Forest,Neco Williams,WAL,DF,23-216,2001,4.2,13,9,11,2,0,5,11,45.5,6,9,1,8,4,17,19,0
2425,Nott'ham Forest,Nicolás Domínguez,ARG,"MF,FW",26-140,1998,5.8,20,10,7,9,4,11,19,57.9,8,14,4,10,9,29,11,0
2425,Nott'ham Forest,Nikola Milenković,SRB,DF,27-034,1997,10.0,10,8,6,4,0,4,5,80.0,1,10,6,4,10,20,39,0
2425,Nott'ham Forest,Ola Aina,NGA,DF,28-038,1996,10.6,22,16,15,6,1,15,22,68.2,7,11,4,7,14,36,28,1
2425,Nott'ham Forest,Ramón Sosa,PAR,"MF,FW",25-076,1999,1.1,3,2,2,0,1,1,2,50.0,1,1,0,1,1,4,2,0
2425,Nott'ham Forest,Ryan Yates,ENG,MF,26-360,1997,9.0,18,9,12,5,1,5,11,45.5,6,9,1,8,10,28,26,1
2425,Nott'ham Forest,Taiwo Awoniyi,NGA,FW,27-095,1997,1.2,1,0,0,1,0,1,1,100.0,0,1,0,1,0,1,2,0
2425,Nott'ham Forest,Willy Boly,CIV,DF,33-286,1991,1.0,4,0,3,1,0,3,3,100.0,0,3,1,2,1,5,8,0
2425,Nott'ham Forest,Álex Moreno,ESP,DF,31-160,1993,6.8,17,12,14,3,0,8,22,36.4,14,8,4,4,10,27,26,0
2425,Southampton,Aaron Ramsdale,ENG,GK,26-185,1998,9.0,0,0,0,0,0,0,1,0.0,1,0,0,0,2,2,6,2
2425,Southampton,Adam Armstrong,ENG,"FW,MF",27-279,1997,5.1,6,1,1,2,3,2,7,28.6,5,1,0,1,2,8,2,0
2425,Southampton,Adam Lallana,ENG,MF,36-189,1988,3.1,5,4,3,2,0,2,7,28.6,5,3,1,2,3,8,5,0
2425,Southampton,Alex McCarthy,ENG,GK,34-348,1989,2.0,0,0,0,0,0,0,0,,0,0,0,0,0,0,0,1
2425,Southampton,Ben Brereton,CHI,FW,25-211,1999,4.5,3,2,0,2,1,1,8,12.5,7,2,1,1,0,3,3,0
2425,Southampton,Cameron Archer,ENG,FW,23-117,2001,6.6,7,4,3,2,2,1,3,33.3,2,4,1,3,1,8,1,0
2425,Southampton,Carlos Alcaraz,ARG,MF,21-351,2002,0.1,0,0,0,0,0,0,0,,0,0,0,0,1,1,0,0
2425,Southampton,Charlie Taylor,ENG,DF,31-058,1993,2.3,7,5,4,3,0,5,6,83.3,1,5,3,2,3,10,20,1
2425,Southampton,Flynn Downes,ENG,MF,25-300,1999,10.0,23,12,12,9,2,6,19,31.6,13,16,3,13,15,38,15,2
2425,Southampton,Jack Stephens,ENG,DF,30-293,1994,6.4,10,7,7,3,0,4,12,33.3,8,4,2,2,3,13,14,2
2425,Southampton,James Bree,ENG,DF,27-035,1997,0.2,0,0,0,0,0,0,0,,0,0,0,0,0,0,0,0
2425,Southampton,Jan Bednarek,POL,DF,28-217,1996,10.9,8,4,6,2,0,3,9,33.3,6,16,14,2,15,23,57,1
2425,Southampton,Joe Aribo,NGA,MF,28-117,1996,6.7,10,6,3,4,3,2,6,33.3,4,6,3,3,6,16,9,1
2425,Southampton,Kamaldeen Sulemana,GHA,"FW,MF",22-274,2002,0.2,3,3,2,0,1,3,3,100.0,0,0,0,0,0,3,1,0
2425,Southampton,Kyle Walker-Peters,ENG,DF,27-216,1997,8.9,13,10,6,5,2,6,14,42.9,8,10,5,5,8,21,18,0
2425,Southampton,Lesley Ugochukwu,FRA,MF,20-234,2004,1.9,4,2,0,4,0,0,4,0.0,4,5,1,4,2,6,1,0
2425,Southampton,Mateus Fernandes,POR,MF,20-128,2004,7.9,27,15,12,10,5,7,17,41.2,10,10,1,9,5,32,12,1
2425,Southampton,Maxwel Cornet,CIV,FW,28-049,1996,0.8,5,5,1,4,0,0,4,0.0,4,0,0,0,0,5,2,0
2425,Southampton,Paul Onuachu,NGA,FW,30-171,1994,0.7,0,0,0,0,0,0,0,,0,0,0,0,1,1,0,0
2425,Southampton,Ross Stewart,SCO,"FW,MF",28-127,1996,1.5,0,0,0,0,0,0,3,0.0,3,3,0,3,0,0,4,0
2425,Southampton,Ryan Fraser,SCO,FW,30-265,1994,1.6,5,2,1,4,0,4,5,80.0,1,0,0,0,0,5,4,0
2425,Southampton,Ryan Manning,IRL,"DF,FW",28-154,1996,3.7,3,2,1,2,0,1,2,50.0,1,5,3,2,3,6,8,0
2425,Southampton,Samuel Amo-Ameyaw,ENG,DF,18-120,2006,0.1,0,0,0,0,0,0,0,,0,0,0,0,0,0,0,0
2425,Southampton,Samuel Edozie,ENG,"DF,FW",21-292,2003,0.7,3,1,0,1,2,2,2,100.0,0,0,0,0,0,3,0,0
2425,Southampton,Taylor Harwood-Bellis,ENG,DF,22-290,2002,9.6,6,4,5,1,0,4,7,57.1,3,23,14,9,8,14,40,2
2425,Southampton,Tyler Dibling,ENG,"FW,MF",18-248,2006,6.3,11,9,5,5,1,5,9,55.6,4,4,1,3,2,13,3,0
2425,Southampton,William Smallbone,IRL,MF,24-268,2000,2.7,7,3,3,3,1,3,5,60.0,2,3,0,3,0,7,2,1
2425,Southampton,Yukinari Sugawara,JPN,DF,24-140,2000,7.4,17,10,10,6,1,9,14,64.3,5,8,3,5,4,21,21,1
2425,Tottenham,Archie Gray,ENG,"MF,DF",18-248,2006,0.5,2,1,0,0,2,1,3,33.3,2,2,0,2,0,2,2,0
2425,Tottenham,Ben Davies,WAL,DF,31-205,1993,0.3,1,0,0,1,0,1,1,100.0,0,0,0,0,1,2,2,0
2425,Tottenham,Brennan Johnson,WAL,FW,23-176,2001,9.6,19,12,3,11,5,8,16,50.0,8,11,1,10,2,21,8,0
2425,Tottenham,Cristian Romero,ARG,DF,26-202,1998,10.7,25,22,20,5,0,14,20,70.0,6,13,3,10,13,38,32,0
2425,Tottenham,Dejan Kulusevski,SWE,"MF,FW",24-204,2000,9.5,12,7,2,2,8,3,15,20.0,12,14,3,11,7,19,7,0
2425,Tottenham,Destiny Udogie,ITA,DF,21-353,2002,10.2,29,17,16,7,6,13,22,59.1,9,18,2,16,13,42,17,1
2425,Tottenham,Djed Spence,ENG,DF,24-098,2000,0.7,2,2,2,0,0,2,2,100.0,0,0,0,0,2,4,1,0
2425,Tottenham,Dominic Solanke,ENG,FW,27-062,1997,8.9,9,6,1,6,2,2,3,66.7,1,6,2,4,0,9,9,0
2425,Tottenham,Guglielmo Vicario,ITA,GK,28-039,1996,11.0,0,0,0,0,0,0,0,,0,0,0,0,1,1,7,2
2425,Tottenham,James Maddison,ENG,MF,27-358,1996,7.6,13,7,4,6,3,6,16,37.5,10,5,2,3,6,19,10,0
2425,Tottenham,Lucas Bergvall,SWE,"MF,FW",18-287,2006,0.6,5,2,0,3,2,5,7,71.4,2,0,0,0,0,5,0,0
2425,Tottenham,Micky van de Ven,NED,DF,23-210,2001,7.9,7,4,3,3,1,5,10,50.0,5,6,4,2,9,16,24,1
2425,Tottenham,Mikey Moore,ENG,FW,17-096,2007,0.9,0,0,0,0,0,0,0,,0,0,0,0,1,1,0,0
2425,Tottenham,Pape Matar Sarr,SEN,MF,22-062,2002,4.9,13,8,4,8,1,1,4,25.0,3,8,2,6,8,21,4,0
2425,Tottenham,Pedro Porro,ESP,DF,25-063,1999,11.0,25,17,11,8,6,17,26,65.4,9,15,5,10,15,40,23,0
2425,Tottenham,Radu Drăgușin,ROU,DF,22-286,2002,3.1,1,0,1,0,0,1,4,25.0,3,4,3,1,3,4,12,2
2425,Tottenham,Richarlison,BRA,FW,27-189,1997,1.0,1,1,0,0,1,0,0,,0,0,0,0,0,1,2,0
2425,Tottenham,Rodrigo Bentancur,URU,MF,27-143,1997,5.9,19,9,9,9,1,11,16,68.8,5,5,0,5,16,35,5,0
2425,Tottenham,Son Heung-min,KOR,FW,32-130,1992,7.4,4,2,0,3,1,2,12,16.7,10,4,0,4,2,6,5,0
2425,Tottenham,Timo Werner,GER,"FW,MF",28-254,1996,3.0,2,2,1,1,0,1,4,25.0,3,9,1,8,1,3,2,0
2425,Tottenham,Wilson Odobert,FRA,FW,19-353,2004,1.8,5,2,2,2,1,4,6,66.7,2,1,0,1,0,5,1,1
2425,Tottenham,Yves Bissouma,MLI,MF,28-077,1996,4.5,12,9,5,6,1,8,13,61.5,5,4,1,3,5,17,13,0
2425,West Ham,Aaron Cresswell,ENG,DF,34-336,1989,0.3,1,0,0,1,0,1,1,100.0,0,1,0,1,0,1,3,0
2425,West Ham,Aaron Wan-Bissaka,ENG,DF,26-355,1997,9.1,16,11,7,7,2,8,10,80.0,2,6,2,4,17,33,30,0
2425,West Ham,Alphonse Areola,FRA,GK,31-262,1993,7.5,1,1,1,0,0,1,2,50.0,1,0,0,0,0,1,5,0
2425,West Ham,Andy Irving,SCO,MF,24-186,2000,0.3,3,2,1,1,1,0,3,0.0,3,1,0,1,0,3,2,0
2425,West Ham,Carlos Soler,ESP,"MF,FW",27-318,1997,3.0,3,3,2,1,0,1,8,12.5,7,5,1,4,2,5,4,0
2425,West Ham,Crysencio Summerville,NED,"MF,FW",23-016,2001,3.8,5,2,1,2,2,1,3,33.3,2,5,2,3,0,5,5,0
2425,West Ham,Danny Ings,ENG,"FW,MF",32-115,1992,0.8,1,0,1,0,0,1,1,100.0,0,0,0,0,0,1,1,0
2425,West Ham,Edson Álvarez,MEX,"MF,DF",27-022,1997,4.5,11,7,7,3,1,6,7,85.7,1,7,2,5,8,19,8,0
2425,West Ham,Emerson Palmieri,ITA,DF,30-104,1994,9.5,28,16,18,8,2,13,21,61.9,8,15,3,12,10,38,21,0
2425,West Ham,Guido Rodríguez,ARG,MF,30-217,1994,8.9,25,13,16,9,0,11,26,42.3,15,15,7,8,10,35,22,1
2425,West Ham,James Ward-Prowse,ENG,MF,30-014,1994,0.2,1,0,1,0,0,1,1,100.0,0,1,0,1,0,1,0,0
2425,West Ham,Jarrod Bowen,ENG,"MF,FW",27-331,1996,10.7,17,8,6,4,7,5,16,31.3,11,8,1,7,5,22,13,0
2425,West Ham,Jean-Clair Todibo,FRA,DF,24-321,1999,5.6,12,7,11,1,0,7,8,87.5,1,9,4,5,6,18,31,2
2425,West Ham,Konstantinos Mavropanos,GRE,DF,26-340,1997,7.2,12,9,9,2,1,6,10,60.0,4,11,9,2,14,26,39,0
2425,West Ham,Lucas Paquetá,BRA,MF,27-080,1997,9.0,15,9,8,6,1,5,13,38.5,8,15,2,13,5,20,10,2
2425,West Ham,Luis Guilherme,BRA,MF,18-280,2006,0.1,0,0,0,0,0,0,0,,0,1,0,1,0,0,0,0
2425,West Ham,Max Kilman,ENG,DF,27-176,1997,11.0,10,5,4,4,2,8,11,72.7,3,16,10,6,13,23,64,1
2425,West Ham,Michail Antonio,JAM,FW,34-232,1990,7.4,1,1,0,0,1,1,2,50.0,1,4,0,4,0,1,2,0
2425,West Ham,Mohammed Kudus,GHA,"MF,FW",24-105,2000,7.4,9,7,2,4,3,3,10,30.0,7,9,1,8,1,10,1,0
2425,West Ham,Niclas Füllkrug,GER,FW,31-280,1993,0.7,0,0,0,0,0,0,0,,0,0,0,0,0,0,2,0
2425,West Ham,Tomáš Souček,CZE,MF,29-262,1995,7.3,14,8,5,7,2,9,17,52.9,8,8,3,5,8,22,23,0
2425,West Ham,Vladimír Coufal,CZE,DF,32-085,1992,2.5,0,0,0,0,0,0,3,0.0,3,2,2,0,2,2,4,0
2425,West Ham,Łukasz Fabiański,POL,GK,39-211,1985,3.5,0,0,0,0,0,0,1,0.0,1,0,0,0,0,0,2,0
2425,Wolves,André,BRA,MF,23-122,2001,4.0,10,5,6,2,2,7,8,87.5,1,12,3,9,2,12,6,0
2425,Wolves,Carlos Forbs,POR,"MF,FW",20-241,2004,2.0,6,5,3,2,1,4,5,80.0,1,3,0,3,0,6,2,1
2425,Wolves,Chiquinho,POR,MF,24-284,2000,0.1,0,0,0,0,0,0,0,,0,0,0,0,0,0,0,0
2425,Wolves,Craig Dawson,ENG,DF,34-193,1990,8.3,13,3,7,5,1,11,14,78.6,3,14,11,3,8,21,43,1
2425,Wolves,Daniel Podence,POR,"MF,FW",29-025,1995,0.5,0,0,0,0,0,0,1,0.0,1,0,0,0,0,0,0,0
2425,Wolves,Gonçalo Guedes,POR,"FW,MF",27-352,1996,1.4,7,2,0,0,7,2,5,40.0,3,4,0,4,2,9,1,0
2425,Wolves,Hwang Hee-chan,KOR,"FW,MF",28-294,1996,2.8,1,0,0,0,1,0,1,0.0,1,5,0,5,1,2,3,0
2425,Wolves,Jean-Ricner Bellegarde,FRA,"MF,FW",26-141,1998,5.3,6,4,2,2,2,2,3,66.7,1,7,1,6,4,10,4,0
2425,Wolves,José Sá,POR,GK,31-303,1993,6.0,0,0,0,0,0,0,0,,0,0,0,0,0,0,3,1
2425,Wolves,João Gomes,BRA,MF,23-277,2001,10.3,35,20,21,13,1,7,29,24.1,22,13,1,12,10,45,8,0
2425,Wolves,Jørgen Strand Larsen,NOR,FW,24-283,2000,9.9,4,4,1,2,1,1,12,8.3,11,8,2,6,3,7,12,0
2425,Wolves,Mario Lemina,GAB,MF,31-075,1993,9.8,33,19,16,13,4,14,19,73.7,5,8,4,4,21,54,26,1
2425,Wolves,Matheus Cunha,BRA,"MF,FW",25-172,1999,9.8,13,9,6,5,2,3,13,23.1,10,11,0,11,5,18,13,0
2425,Wolves,Matt Doherty,IRL,DF,32-304,1992,2.3,8,6,6,2,0,4,5,80.0,1,4,1,3,2,10,8,0
2425,Wolves,Nélson Semedo,POR,DF,30-365,1993,8.7,19,10,13,3,3,8,19,42.1,11,9,3,6,4,23,48,1
2425,Wolves,Pablo Sarabia,ESP,"MF,FW",32-188,1992,2.0,5,3,2,2,1,3,5,60.0,2,3,0,3,2,7,2,1
2425,Wolves,Rayan Aït-Nouri,ALG,DF,23-162,2001,10.2,22,11,16,5,1,10,17,58.8,7,12,2,10,11,33,22,1
2425,Wolves,Rodrigo Gomes,POR,"FW,MF",21-131,2003,1.3,4,1,2,2,0,1,4,25.0,3,2,0,2,0,4,1,0
2425,Wolves,Sam Johnstone,ENG,GK,31-235,1993,5.0,0,0,0,0,0,0,0,,0,0,0,0,0,0,5,0
2425,Wolves,Santiago Bueno,URU,DF,26-006,1998,4.9,9,5,5,4,0,6,8,75.0,2,12,8,4,4,13,19,0
2425,Wolves,Tommy Doyle,ENG,MF,23-029,2001,3.0,3,1,0,3,0,2,5,40.0,3,3,1,2,2,5,5,0
2425,Wolves,Toti Gomes,POR,DF,25-304,1999,8.2,18,14,12,5,1,7,9,77.8,2,4,2,2,4,22,36,1
2425,Wolves,Yerson Mosquera,COL,DF,23-197,2001,4.9,11,7,9,2,0,9,14,64.3,5,13,10,3,10,21,14,0
